name,eng,hin,mth,sci,total,avg
Ashish,45,65,76,78,264,66.0
Raj,65,45,65,76,251,62.75
Rohini,65,67,6,55,193,48.25
Rakesh,65,66,77,88,296,74.0
Rajesh,88,77,87,89,341,85.25
Manish,65,45,45,45,200,50.0
Manoj,45,66,88,56,255,63.75
Suraj,55,45,76,87,263,65.75
Sumit,66,77,45,89,277,69.25
Ratish,66,55,66,45,232,58.0
Tanisha,77,66,56,87,286,71.5
Anonymous,98,89,98,88,373,93.25
Anonymous,22,23,34,32,111,27.75
